+====+====+====+====+====+
|    |    |    |    |    |
+====+====+====+====+====+
|    |    | R3 | R4 |    |
+====+====+====+====+====+
|    |    | R2 |    |    |
+====+====+====+====+====+
|    | R1 |    |    | R5 |
+====+====+====+====+====+
|    |    |    |    |    |
+====+====+====+====+====+


R1
R2
R3
R4
R5